o,o,o,o,o,o,o,o,o,o,o,o,o,o,o,o,o,o,o,o,o,o,o,o,o,o,o,o,o,o,o,o,o,o,o,o,o,o,o,o,o,o,o,o,o,o,o,o,o,o,o,o,o,o,o,o,o,o,o,o,o,o,o,o,o,o,o,o,o,o,o,o,o,o,o,o,o,o,o,o,o,o,o,o,o,o,o,o,o,o,o,o,o,o,o,o,o,o,o,o,o,o,o,o,o,o,o,o,o,o,o,o,o,o,o,o,o,o,o,o,o,o,o,o,o,o,o,o
o,o,o,o,o,o,o,o,o,o,o,o,o,o,o,o,o,o,o,o,o,o,o,o,o,o,o,o,o,o,o,o,K,K,M,T,L,M,T,L,K,K,K,K,K,K,o,o,o,o,o,o,o,o,o,o,o,o,o,o,o,o,o,o,o,o,o,o,o,o,o,o,o,o,o,o,o,o,o,o,o,o,o,o,o,o,o,o,o,o,o,o,o,o,o,o,o,o,o,o,o,o,o,o,o,o,o,o,o,o,o,o,o,o,o,K,K,K,K,K,K,K,K,K,K,K,K,o
o,o,o,o,o,o,o,o,o,o,o,o,o,o,o,o,o,o,o,o,o,o,o,o,o,o,o,o,o,o,o,o,a,B,v,B,v,B,B,v,B,v,b,E,v,b,o,o,o,o,o,o,o,o,o,o,o,o,o,o,o,o,o,o,o,o,o,o,o,o,o,o,o,o,o,o,o,o,o,o,o,o,o,o,o,o,o,o,o,o,o,o,o,o,o,o,o,o,o,o,o,o,o,o,o,o,o,o,o,o,o,o,o,o,o,a,v,v,A,B,B,A,B,A,A,B,b,o
o,o,o,o,o,o,o,o,o,o,o,o,o,o,o,o,o,o,o,o,o,o,o,o,o,o,o,o,o,o,o,o,a,C,C,C,C,C,C,C,C,C,b,G,D,b,o,o,o,o,o,o,o,o,o,o,o,o,o,o,o,o,o,o,o,o,o,o,o,o,o,o,o,o,o,o,o,o,o,o,o,o,o,o,o,o,o,o,o,o,o,o,o,o,o,o,o,o,o,o,o,o,o,o,o,o,o,o,o,o,o,o,o,o,o,a,C,C,C,C,C,C,C,C,D,D,b,o
o,o,o,o,o,o,o,o,o,o,o,o,o,o,o,o,o,o,o,o,o,o,o,o,o,o,o,o,o,o,o,o,a,C,C,C,C,C,C,C,C,C,b,G,D,b,o,o,o,o,o,o,o,o,o,o,o,o,o,o,o,o,o,o,o,o,o,o,o,o,o,o,o,o,o,o,o,o,o,o,o,o,o,o,o,o,o,o,o,o,o,o,o,o,o,o,o,o,o,o,o,o,o,o,o,o,o,o,o,o,o,o,o,o,o,a,C,C,C,C,C,C,C,C,d,D,b,o
o,o,o,o,o,o,o,o,o,o,o,o,o,o,o,o,o,o,o,o,o,o,o,o,o,o,o,o,o,o,o,o,a,C,C,C,C,C,C,C,C,C,b,G,D,b,o,o,o,o,K,K,K,K,K,o,o,o,o,o,o,o,o,o,o,o,o,o,o,o,o,o,o,o,o,o,o,o,o,o,o,o,o,o,o,o,o,o,o,o,o,o,o,o,o,o,o,o,o,o,o,o,o,o,o,o,o,o,o,o,o,o,o,o,o,a,C,C,C,C,C,C,C,C,C,D,b,o
o,o,o,o,o,o,o,o,o,o,o,o,o,o,o,o,o,o,o,o,o,o,o,o,o,o,o,o,o,o,o,o,a,C,C,C,C,C,C,C,C,C,b,G,D,b,o,o,o,o,a,B,A,B,b,o,o,o,o,o,o,o,o,o,o,o,o,o,o,o,o,o,o,o,o,o,o,o,o,o,o,o,o,o,o,o,o,o,o,o,o,o,o,o,o,o,o,o,o,o,o,o,o,o,o,o,o,o,o,o,o,o,o,o,o,a,C,C,C,C,C,C,C,C,C,C,b,o
o,o,o,o,o,o,o,o,o,o,o,o,o,o,o,o,o,o,o,o,o,o,o,o,o,o,o,o,o,o,o,o,a,C,C,C,C,C,C,C,C,C,b,G,D,b,o,o,o,o,a,C,C,C,b,o,o,o,o,o,o,o,o,o,o,o,o,o,o,o,o,o,o,o,o,o,o,o,o,o,o,o,o,o,o,o,o,o,o,o,o,o,o,o,o,o,o,o,o,o,o,o,o,o,o,o,o,o,o,o,o,o,o,o,o,a,C,C,C,C,C,C,C,C,C,C,b,o
o,o,o,o,o,o,o,o,o,o,o,o,o,o,o,o,o,o,o,o,o,o,o,o,o,o,o,o,o,o,o,o,a,C,C,C,C,C,C,C,C,C,b,G,D,b,o,o,o,o,a,D,D,C,b,o,o,o,o,o,o,o,o,o,o,o,o,o,o,o,o,o,o,o,o,o,o,o,o,o,o,o,o,o,o,o,o,o,o,o,o,o,o,o,o,o,o,o,o,o,o,o,o,o,o,o,o,o,o,o,o,o,o,o,o,a,C,C,C,C,C,C,C,C,C,C,b,o
o,o,o,o,o,o,o,o,o,o,o,o,o,o,o,o,o,o,o,o,o,o,K,K,N,K,K,N,K,K,N,K,c,C,C,C,C,C,C,C,C,C,f,M,C,L,K,K,K,K,c,C,C,C,f,K,K,K,K,K,K,K,K,K,K,K,K,K,o,o,o,o,o,o,o,o,o,o,o,o,o,o,o,o,o,o,o,o,o,o,o,o,o,o,o,o,o,o,o,o,o,o,o,o,o,o,o,o,o,o,o,o,o,o,o,a,C,C,C,C,C,C,C,C,C,C,b,o
o,o,o,o,o,o,o,o,o,o,o,o,o,o,o,o,o,o,o,o,o,o,a,A,v,A,A,v,A,B,A,B,v,C,C,C,C,C,C,C,C,C,C,B,C,B,B,B,B,B,C,C,C,C,C,B,B,B,B,D,D,B,B,B,B,B,B,b,o,o,o,o,o,o,o,o,o,o,o,o,o,o,o,o,o,o,o,o,o,o,o,o,o,o,o,o,o,o,o,o,o,o,o,o,o,o,o,o,o,o,o,o,o,o,o,a,D,C,C,C,C,C,C,C,C,C,b,o
o,o,o,o,o,o,o,o,o,o,o,o,o,o,o,o,o,o,o,o,o,o,a,C,C,C,C,C,C,C,C,C,C,C,C,C,C,C,C,C,C,C,C,C,C,C,C,C,C,C,C,C,C,C,C,C,C,C,C,D,D,C,C,C,C,C,C,b,o,o,o,o,o,o,o,o,o,o,o,o,o,o,o,o,o,o,o,o,o,o,o,o,o,o,o,o,o,o,o,o,o,o,o,o,o,o,o,o,o,o,o,o,o,o,o,a,D,D,C,C,C,C,C,C,C,C,b,o
o,o,o,o,o,o,o,o,o,o,o,o,o,o,o,o,o,o,o,o,o,o,a,C,C,C,C,C,C,C,C,C,C,C,C,C,C,C,C,C,C,C,C,C,C,C,C,C,C,C,C,C,C,C,C,C,C,C,C,D,D,C,C,C,C,C,C,f,K,K,K,K,K,K,K,K,K,K,K,K,K,K,K,K,K,K,K,K,K,K,K,K,K,K,K,K,K,K,K,K,K,K,K,K,K,K,K,K,K,K,K,K,K,K,K,c,C,C,C,C,C,C,C,C,C,C,b,o
o,o,o,o,o,o,o,o,o,o,o,o,o,o,o,o,o,o,o,o,o,o,a,C,C,C,C,C,C,C,C,C,C,C,C,C,C,C,C,C,C,C,C,C,C,C,C,C,C,C,C,C,C,C,C,C,C,C,C,D,D,C,C,C,C,C,C,C,B,B,B,B,B,B,B,v,B,v,B,B,v,B,B,B,B,B,v,B,B,v,B,B,B,B,B,v,B,B,v,B,B,B,B,B,B,B,B,B,B,B,B,B,v,B,B,C,C,C,C,C,C,C,C,C,C,C,b,o
K,K,N,N,K,N,K,N,K,K,N,K,K,N,K,K,K,K,K,K,K,K,c,C,C,C,C,C,C,C,C,C,C,C,C,C,C,C,C,C,C,C,C,C,C,C,C,C,C,C,C,C,C,C,C,C,C,C,C,D,D,C,C,C,C,C,C,C,C,C,C,C,C,d,C,C,C,C,C,C,C,C,C,C,C,D,C,C,C,C,C,C,C,C,C,C,C,C,C,C,C,C,C,C,C,C,C,D,D,C,C,C,C,C,C,C,C,C,C,C,C,C,C,C,C,C,b,o
A,B,A,B,v,v,B,B,A,B,B,A,B,A,v,B,A,A,B,A,B,v,C,C,C,C,C,C,C,b,N,N,N,N,N,N,a,C,C,C,C,C,C,C,C,C,C,C,C,C,C,C,C,C,C,C,C,C,C,D,D,C,C,C,C,C,C,C,C,C,C,C,C,d,C,C,C,C,C,C,C,C,C,C,C,D,D,C,C,C,C,C,C,C,C,C,D,D,C,C,C,C,C,C,C,C,C,C,D,C,C,C,C,C,C,C,C,C,C,C,C,C,C,C,C,C,b,o
C,F,C,C,C,F,C,C,C,C,C,C,C,C,C,C,D,C,C,C,C,C,C,C,C,C,C,C,C,b,o,o,o,o,o,o,a,C,C,C,C,C,C,C,C,C,C,C,C,C,C,C,C,C,C,C,C,C,C,D,D,C,C,C,C,C,C,C,C,C,C,C,C,C,C,C,C,C,C,C,C,C,C,C,C,C,C,C,C,C,C,C,C,C,C,C,d,D,C,C,C,C,C,C,C,C,C,C,C,C,C,C,C,C,C,C,C,C,C,C,C,C,C,C,C,C,b,o
C,C,C,C,C,C,C,C,C,C,C,C,C,C,C,C,C,C,C,C,C,C,C,C,C,C,C,C,C,b,o,M,T,N,N,o,a,C,C,C,C,C,C,C,C,C,C,C,C,C,C,C,C,C,C,C,C,C,C,b,K,K,K,K,K,K,K,K,K,K,K,K,K,K,K,K,K,K,K,K,K,K,K,K,K,K,K,K,K,K,K,K,K,K,K,K,K,K,K,K,a,b,K,K,K,K,K,K,a,b,K,K,K,K,K,a,C,C,C,C,C,C,C,C,C,C,b,o
C,C,C,C,C,C,C,C,C,C,C,C,D,C,C,C,C,C,C,C,D,C,C,C,C,C,C,C,C,b,o,a,B,B,b,o,a,C,C,C,C,C,C,C,C,C,C,C,C,C,C,C,C,C,C,C,C,C,C,b,o,o,o,o,o,o,o,o,o,o,o,o,o,o,o,o,o,o,o,o,o,o,o,o,o,o,o,o,o,o,o,o,o,o,o,o,o,o,o,o,a,b,o,o,o,o,o,o,a,b,o,o,o,o,o,a,C,C,C,C,C,C,C,C,C,C,b,o
C,C,C,C,C,C,C,F,C,C,C,C,D,D,C,C,C,C,C,C,C,C,C,C,C,C,C,C,C,b,o,a,D,D,b,o,a,C,C,C,C,C,C,C,C,C,C,C,C,C,C,C,C,C,C,C,C,C,C,b,o,o,o,o,o,o,o,o,o,o,o,o,o,o,o,o,o,o,o,o,o,o,o,o,o,o,o,o,o,o,o,o,o,o,o,o,o,o,o,o,a,b,o,o,o,o,o,o,a,b,o,o,o,o,o,a,D,D,C,C,C,C,C,C,C,C,b,o
C,C,C,C,C,C,C,C,C,C,C,C,C,C,C,C,C,C,F,C,C,D,C,C,C,C,C,C,C,b,o,a,D,D,b,o,a,C,C,C,C,C,C,C,C,C,C,C,C,C,C,C,C,C,C,C,C,C,C,b,o,o,o,o,o,o,o,o,o,o,o,o,o,o,o,o,o,o,o,o,o,o,o,o,o,o,o,o,o,o,o,o,o,o,o,o,o,o,o,o,a,b,o,o,o,o,o,o,a,b,o,o,o,o,o,a,D,D,C,C,C,C,C,C,C,C,b,o
C,C,C,C,C,C,C,C,C,C,C,C,C,C,C,C,C,C,C,C,C,C,C,C,C,C,C,C,C,b,o,K,K,K,K,o,a,C,C,C,C,C,C,C,C,C,C,C,C,C,C,C,b,K,K,K,K,K,K,K,o,o,o,o,o,o,o,o,o,o,o,o,o,o,o,o,o,o,o,o,o,o,o,o,o,o,o,o,o,o,o,o,o,o,o,o,o,o,o,o,a,b,o,o,o,o,o,o,a,b,o,o,o,o,o,a,D,C,C,C,C,C,C,C,C,C,b,o
C,C,C,C,C,C,C,C,C,C,C,C,D,C,C,C,C,C,C,C,C,C,C,C,C,C,C,C,C,b,o,o,o,o,o,o,a,C,C,C,C,C,C,C,C,C,C,C,C,C,C,C,b,o,o,o,o,o,o,o,o,o,o,o,o,o,o,o,o,o,o,o,o,o,o,o,o,o,o,o,o,o,o,o,o,o,o,o,o,o,o,o,o,o,o,o,o,o,o,o,a,b,o,o,o,o,o,o,a,b,o,o,o,o,o,a,C,C,C,C,C,C,C,C,C,C,b,o
C,C,C,C,C,C,D,C,C,C,F,C,C,C,C,C,C,C,C,C,C,F,C,C,C,C,C,C,C,f,N,N,N,N,N,N,c,C,C,C,C,C,C,C,C,C,C,C,C,C,C,C,b,o,o,o,o,o,o,o,o,o,o,o,o,o,o,o,o,o,o,o,o,o,o,o,o,o,o,o,o,o,o,o,o,o,o,o,o,o,o,o,o,o,o,o,o,o,o,o,a,b,o,o,o,o,o,o,a,b,o,o,o,o,o,a,C,C,C,C,C,C,C,C,C,C,b,o
C,C,D,C,C,C,C,C,C,C,C,C,F,C,C,C,D,C,C,C,F,C,C,C,C,C,C,C,C,C,C,C,C,C,C,D,D,D,C,C,C,C,C,C,C,C,C,C,C,C,C,C,b,o,o,o,o,o,o,o,o,o,o,o,o,o,o,o,o,o,o,o,o,o,o,o,o,o,o,o,o,o,o,o,o,o,o,o,o,o,o,o,o,o,o,o,o,o,o,o,a,b,o,o,o,o,o,o,a,b,o,o,o,o,o,a,C,C,C,C,C,C,C,D,D,C,b,o
C,C,C,C,C,C,C,C,C,C,C,C,C,C,C,C,C,C,C,C,C,C,C,C,C,C,C,C,C,C,C,C,C,C,C,D,D,D,D,C,C,C,C,C,C,C,C,C,C,C,C,C,b,o,o,o,o,o,o,o,o,o,o,o,o,o,o,o,o,o,o,o,o,o,o,o,o,o,o,o,o,o,o,o,o,o,o,o,o,o,o,o,o,o,o,o,o,o,o,o,a,b,o,o,o,o,o,o,a,b,o,o,o,o,o,a,C,C,C,C,C,C,C,C,D,C,b,o
K,K,N,K,K,N,K,K,K,N,K,K,K,N,K,N,K,K,N,K,K,N,a,C,C,C,C,C,C,C,C,C,C,C,C,C,C,D,b,K,K,K,K,K,a,C,C,C,C,C,C,C,b,o,o,o,o,o,o,o,o,o,o,o,o,o,o,o,o,o,o,o,o,o,o,o,o,o,o,o,o,o,o,o,o,o,o,o,o,o,o,o,o,o,o,o,o,o,o,o,a,b,o,o,o,o,o,o,a,b,o,o,o,o,o,a,C,C,C,C,C,C,C,C,C,C,b,o
o,o,o,o,o,o,o,o,o,o,o,o,o,o,o,o,o,o,o,o,o,o,a,C,C,b,K,K,K,K,K,K,K,K,K,K,a,C,b,o,o,o,o,o,a,C,C,C,C,C,C,C,b,o,o,o,o,o,o,o,o,o,o,o,o,o,o,o,o,o,o,o,o,o,o,o,o,o,o,o,o,o,o,o,o,o,o,o,o,o,o,o,o,o,o,o,o,o,o,o,a,b,o,o,o,o,o,o,a,b,o,o,o,o,o,a,C,C,C,C,C,C,C,C,C,C,b,o
o,o,o,o,o,o,o,o,o,o,o,o,o,o,o,o,o,o,o,o,o,o,a,C,C,b,o,o,o,o,o,o,o,o,o,o,a,C,b,o,o,o,o,o,a,C,C,C,C,C,C,C,b,o,o,o,o,o,o,o,o,o,o,o,o,o,o,o,o,o,o,o,o,o,o,o,o,o,o,o,o,o,o,o,o,o,o,o,o,o,o,o,o,o,o,o,o,o,o,o,a,f,K,K,K,K,K,K,c,f,K,K,K,K,K,c,C,C,C,C,C,C,C,C,C,C,b,o
o,o,o,o,o,o,o,o,o,o,o,o,o,o,o,o,o,o,o,o,o,o,a,C,C,b,o,K,K,M,T,T,L,K,K,o,a,C,b,o,o,o,o,o,a,C,C,C,C,C,C,C,b,o,o,o,o,o,o,o,o,o,o,o,o,o,o,o,o,o,o,o,K,K,K,M,T,L,K,K,K,o,o,o,o,o,o,o,o,o,o,o,o,o,o,o,o,o,o,o,a,D,D,v,D,D,D,D,D,D,D,v,D,D,D,D,D,D,D,D,D,D,D,D,D,D,b,o
o,o,o,o,o,o,o,o,o,o,o,o,o,o,o,o,o,o,o,o,o,o,a,C,C,b,o,a,v,B,A,B,A,v,b,o,a,D,b,o,o,o,o,o,a,C,C,C,C,C,C,C,b,o,o,o,o,o,o,o,o,o,o,o,o,o,o,o,o,o,o,o,a,v,v,B,B,B,v,v,b,o,o,o,o,o,o,o,o,o,o,o,o,o,o,o,o,o,o,o,K,K,K,K,K,K,K,K,K,K,K,K,K,K,K,K,K,K,K,K,K,K,K,K,K,K,K,o
o,o,o,o,o,o,o,o,o,o,o,o,o,o,o,o,o,o,o,o,o,o,a,C,C,b,o,a,C,C,C,C,C,C,b,o,a,C,b,o,o,o,o,o,K,K,K,K,K,K,K,K,K,o,o,o,o,o,o,o,o,o,o,o,o,o,o,o,o,o,o,o,a,C,C,C,C,C,C,d,b,o,o,o,o,o,o,o,o,o,o,o,o,o,o,o,o,o,o,o,o,o,o,o,o,o,o,o,o,o,o,o,o,o,o,o,o,o,o,o,o,o,o,o,o,o,o,o
o,o,o,o,o,o,o,o,o,o,o,o,o,o,o,o,o,o,o,o,o,o,a,C,C,b,o,a,C,C,C,C,C,C,b,o,a,C,b,o,o,o,o,o,o,o,o,o,o,o,o,o,o,o,o,o,o,o,o,o,o,o,o,o,o,o,o,o,o,o,o,o,a,C,C,D,D,C,C,C,b,o,o,o,o,o,N,K,K,N,K,K,o,o,o,o,o,o,o,o,o,o,o,o,o,o,o,o,o,o,o,o,o,o,o,o,o,o,o,o,o,o,o,o,o,o,o,o
o,o,o,o,o,o,o,o,o,o,o,o,o,o,o,o,o,o,o,o,o,o,a,C,C,b,o,a,D,C,C,C,C,C,b,o,a,C,b,o,o,o,o,o,o,o,o,o,o,o,o,o,o,o,o,o,o,o,o,o,o,o,o,o,o,o,o,o,o,o,o,o,a,C,C,D,C,C,C,C,b,o,o,o,o,o,a,B,A,B,v,b,o,o,o,o,o,o,o,o,o,o,o,o,o,o,o,o,o,o,o,o,o,o,o,o,o,o,o,o,o,o,o,o,o,o,o,o
o,o,o,o,o,o,o,o,o,o,o,o,o,o,o,o,o,o,o,o,o,o,a,C,C,b,o,K,K,K,K,K,K,K,K,o,a,C,b,o,o,o,o,o,o,o,o,o,o,o,o,o,o,o,o,o,o,o,o,o,o,o,o,o,o,o,o,o,o,o,o,o,a,D,C,C,C,C,D,D,f,N,N,N,N,N,c,C,C,C,D,b,o,o,o,o,o,o,o,o,o,o,o,o,o,o,o,o,o,o,o,o,o,o,o,o,o,o,o,o,o,o,o,o,o,o,o,o
o,o,o,o,o,o,o,o,o,o,o,o,o,o,o,o,o,o,o,o,o,o,a,C,C,b,o,o,o,o,o,o,o,o,o,o,a,C,b,o,o,o,o,o,o,o,o,o,o,o,o,o,o,o,o,o,o,o,o,o,o,o,o,o,o,o,o,o,o,o,o,o,a,D,C,C,C,C,C,C,C,C,C,C,C,C,C,C,C,C,D,b,o,o,o,o,o,o,o,o,o,o,o,o,o,o,o,o,o,o,o,o,o,o,o,o,o,o,o,o,o,o,o,o,o,o,o,o
o,o,o,o,o,o,o,o,o,o,o,o,o,o,o,o,o,o,o,o,o,o,a,C,C,f,K,K,K,K,K,K,K,K,K,K,c,D,b,o,o,o,o,o,o,o,o,o,o,o,o,o,o,o,o,o,o,o,o,o,o,o,o,o,o,o,o,o,o,o,o,o,K,K,K,K,K,K,K,K,K,K,K,K,K,K,K,K,K,K,K,K,o,o,o,o,o,o,o,o,o,o,o,o,o,o,o,o,o,o,o,o,o,o,o,o,o,o,o,o,o,o,o,o,o,o,o,o
o,o,o,o,o,o,o,o,o,o,o,o,o,o,o,o,o,o,o,o,o,o,a,C,C,C,B,B,B,B,B,B,B,B,B,B,C,C,b,o,o,o,o,o,o,o,o,o,o,o,o,o,o,o,o,o,o,o,o,o,o,o,o,o,o,o,o,o,o,o,o,o,o,o,o,o,o,o,o,o,o,o,o,o,o,o,o,o,o,o,o,o,o,o,o,o,o,o,o,o,o,o,o,o,o,o,o,o,o,o,o,o,o,o,o,o,o,o,o,o,o,o,o,o,o,o,o,o
o,o,o,o,o,o,o,o,o,o,o,o,o,o,o,o,o,o,o,o,o,o,a,C,C,C,C,C,C,C,C,C,C,C,C,C,C,d,b,o,o,o,o,o,o,o,o,o,o,o,o,o,o,o,o,o,o,o,o,o,o,o,o,o,o,o,o,o,o,o,o,o,o,o,o,o,o,o,o,o,o,o,o,o,o,o,o,o,o,o,o,o,o,o,o,o,o,o,o,o,o,o,o,o,o,o,o,o,o,o,o,o,o,o,o,o,o,o,o,o,o,o,o,o,o,o,o,o
o,o,o,o,o,o,o,o,o,o,o,o,o,o,o,o,o,o,o,o,o,o,K,K,K,K,K,K,K,K,K,K,K,K,K,K,K,K,K,o,o,o,o,o,o,o,o,o,o,o,o,o,o,o,o,o,o,o,o,o,o,o,o,o,o,o,o,o,o,o,o,o,o,o,o,o,o,o,o,o,o,o,o,o,o,o,o,o,o,o,o,o,o,o,o,o,o,o,o,o,o,o,o,o,o,o,o,o,o,o,o,o,o,o,o,o,o,o,o,o,o,o,o,o,o,o,o,o
