            *   *   *  
            *   *   *  
            *   *   *  
            :   *   :  
            :   :   :  
            :   :   :  
            +   :   +  
            +   +   +  
            +   +   +  